1,1,1,1,1,1,1,1,1,1,1,1,1,1,1,1,1,
1,0,0,0,0,0,0,0,0,0,0,0,0,0,0,0,1,
1,6,0,0,6,0,0,0,6,0,0,0,0,6,0,6,1,
1,3,3,3,3,3,3,3,3,3,3,3,3,3,3,3,1,
1,2,2,1,2,2,1,2,1,2,1,2,2,1,2,2,1,
1,0,0,0,0,0,0,0,0,0,0,0,0,0,0,0,1,
1,0,0,0,0,0,3,3,3,3,3,0,0,0,0,0,1,
1,0,0,0,0,0,3,2,2,2,3,0,0,0,0,0,1,
1,0,7,0,0,0,3,2,4,2,3,0,0,0,8,0,1,
1,0,0,0,0,0,3,2,2,2,3,0,0,0,0,0,1,
1,0,0,0,0,0,3,3,3,3,3,0,0,0,0,0,1,
1,0,0,0,0,0,0,0,0,0,0,0,0,0,0,0,1,
1,2,2,1,2,2,1,2,1,2,1,2,2,1,2,2,1,
1,3,3,3,3,3,3,3,3,3,3,3,3,3,3,3,1,
1,6,0,6,0,0,0,0,6,0,0,0,0,6,0,6,1,
1,0,0,0,0,0,0,0,0,0,0,0,0,0,0,0,1,
1,1,1,1,1,1,1,1,1,1,1,1,1,1,1,1,1