1,1,1,1,1,1,1,1,1,1,1,1,1,1,1,1,1,
1,0,0,0,1,2,2,2,4,2,2,2,1,0,0,0,1,
1,0,0,0,1,3,3,2,2,2,2,2,1,0,0,0,1,
1,1,1,1,1,2,2,2,1,2,2,2,1,1,1,1,1,
1,1,3,3,3,1,3,3,1,3,3,1,3,3,3,1,1,
1,1,3,3,3,3,3,3,3,3,3,3,3,3,3,1,1,
1,1,2,2,2,2,2,2,1,2,2,2,2,2,2,1,1,
1,1,5,1,3,3,2,2,1,2,2,3,3,1,5,1,1,
1,1,0,1,3,3,2,2,1,2,2,3,3,1,0,1,1,
1,1,6,1,1,2,0,0,1,0,0,2,1,1,6,1,1,
1,1,0,1,1,2,0,0,1,0,0,2,1,1,0,1,1,
1,1,0,0,0,2,0,6,1,6,0,2,0,0,0,1,1,
1,1,6,1,1,1,1,1,1,1,1,1,1,6,1,1,1,
1,1,0,0,5,0,0,0,1,0,0,5,0,0,1,1,1,
1,1,1,1,1,1,1,0,1,0,1,1,1,1,1,1,1,
1,7,5,0,0,0,0,0,1,0,0,0,0,0,5,8,1,
1,1,1,1,1,1,1,1,1,1,1,1,1,1,1,1,1