1,1,1,1,1,1,1,1,1,1,1,1,1,1,1,1,1,
1,0,6,0,0,0,0,0,6,0,0,0,0,0,6,0,1,
1,0,0,0,0,0,0,0,0,0,0,0,0,0,0,0,1,
1,0,0,0,0,0,0,0,0,0,0,0,0,0,0,0,1,
1,0,0,2,2,2,2,2,1,2,2,2,2,2,0,0,1,
1,0,0,2,0,0,0,0,0,0,0,0,0,2,0,0,1,
1,0,0,2,0,0,0,0,0,0,0,0,0,2,0,0,1,
1,0,0,2,0,0,0,2,2,2,0,0,0,2,0,0,1,
1,6,0,1,0,7,0,2,4,2,0,8,0,1,0,6,1,
1,0,0,2,0,0,0,2,2,2,0,0,0,2,0,0,1,
1,0,0,2,0,0,0,0,0,0,0,0,0,2,0,0,1,
1,0,0,2,0,0,0,0,0,0,0,0,0,2,0,0,1,
1,0,0,2,2,2,2,2,1,2,2,2,2,2,0,0,1,
1,0,0,0,0,0,0,0,0,0,0,0,0,0,0,0,1,
1,0,0,0,0,0,0,0,0,0,0,0,0,0,0,0,1,
1,0,6,0,0,0,0,0,6,0,0,0,0,0,0,0,1,
1,1,1,1,1,1,1,1,1,1,1,1,1,1,1,1,1