1,1,1,1,1,1,1,1,1,1,1,1,1,1,1,1,1,
1,0,0,6,6,6,0,0,0,0,1,0,6,6,6,0,1,
1,0,0,0,0,0,0,0,0,0,1,0,0,0,0,0,1,
1,0,0,0,0,0,0,0,0,0,1,0,0,0,0,0,1,
1,2,2,2,2,1,1,1,2,2,1,2,2,2,2,2,1,
1,0,0,0,0,0,0,1,0,0,0,3,3,3,3,3,1,
1,0,0,0,0,0,0,1,0,0,0,0,0,0,0,0,1,
1,0,0,0,0,0,0,1,0,0,0,0,3,3,0,0,1,
1,2,2,2,2,2,2,2,2,2,2,2,1,1,2,2,1,
1,0,5,0,0,0,0,0,0,0,1,3,3,0,5,0,1,
1,0,0,0,0,8,0,0,0,0,2,3,3,0,0,0,1,
1,0,0,0,0,0,0,0,0,0,2,3,3,0,0,0,1,
1,0,0,0,2,2,1,1,1,2,1,2,2,2,0,7,1,
1,0,0,0,0,0,0,2,2,2,2,2,0,0,0,0,1,
1,0,0,5,0,0,0,2,2,2,2,2,0,0,5,0,1,
1,0,0,0,0,0,0,2,4,2,2,1,0,0,0,0,1,
1,1,1,1,1,1,1,1,1,1,1,1,1,1,1,1,1