1,1,1,1,1,1,1,1,1,1,1,1,1,1,1,1,1,
1,6,2,3,2,3,2,3,2,3,2,3,2,3,2,6,1,
1,2,3,2,3,3,3,2,3,2,3,3,3,2,3,2,1,
1,3,2,3,2,3,2,3,2,3,2,3,2,3,2,3,1,
1,2,3,2,3,2,3,2,3,2,3,2,3,2,3,2,1,
1,3,3,3,2,3,2,3,2,3,2,3,2,3,0,3,1,
1,2,3,2,3,2,3,2,3,2,3,2,3,2,3,2,1,
1,3,2,3,2,3,2,1,2,1,2,3,2,3,2,3,1,
1,2,3,2,3,2,7,2,4,2,8,2,3,2,3,2,1,
1,3,2,3,2,3,2,1,2,1,2,3,2,3,2,3,1,
1,2,3,2,3,2,3,2,3,2,3,2,3,2,3,2,1,
1,3,3,3,2,3,2,3,2,3,2,3,2,3,0,3,1,
1,2,3,2,3,2,3,2,3,2,3,2,3,2,3,2,1,
1,3,2,3,2,3,2,3,2,3,2,3,2,3,2,3,1,
1,2,3,2,3,3,3,2,3,2,3,0,3,2,3,2,1,
1,6,2,3,2,3,2,3,2,3,2,3,2,3,2,6,1,
1,1,1,1,1,1,1,1,1,1,1,1,1,1,1,1,1