1,1,1,1,1,1,1,1,1,1,1,1,1,1,1,1,1,
1,0,0,0,0,0,0,0,7,0,1,0,6,6,6,0,1,
1,0,0,0,0,0,0,0,0,8,1,0,0,0,0,0,1,
1,0,0,5,9,10,11,0,0,0,1,1,2,2,2,1,1,
1,2,2,2,2,1,1,1,1,1,1,3,3,3,3,3,1,
1,0,0,0,0,0,0,1,0,0,0,0,0,0,0,0,1,
1,0,0,0,0,0,0,2,0,0,0,0,0,0,0,0,1,
1,0,0,0,0,0,0,2,0,0,0,0,3,3,0,0,1,
1,1,1,1,1,1,1,1,1,1,1,1,2,2,1,1,1,
1,0,0,0,0,0,0,0,0,0,2,3,3,3,0,0,1,
1,0,0,0,0,0,0,0,0,0,2,3,3,3,0,0,1,
1,0,0,0,0,0,0,0,0,0,2,3,3,3,0,0,1,
1,0,0,0,1,1,1,1,1,2,2,1,1,1,0,0,1,
1,0,0,0,0,0,0,2,2,2,2,1,0,0,0,0,1,
1,0,0,0,0,0,0,2,2,2,2,1,0,0,0,0,1,
1,0,0,0,0,0,0,2,4,2,2,1,0,0,0,0,1,
1,1,1,1,1,1,1,1,1,1,1,1,1,1,1,1,1